1 1
11 9
###########
# #   #   #
# # # # # #
# # # # # #
# # # # # #
# # # # # #
# # # # # #
#   #   #O#
###########